# A
Ability : Disability
Accept : Reject, refuse
Acquit : Convict
# B
Barbarous : Civilized
Barren : Fertile
Base : Noble
# C
Callous : Soft, tender
Care : Neglect
Censure : Praise, applaud
# D
Danger : Safety
Deep : Shallow
Delight : Despleasure, sorrow
# E
Early : Late
Elevation : Depression
Emancipate : Enslave
# F
Fabulous : Actual, real
Failure : Success
Fickle : Constant
# G
Gain : Loss
Genuine : False
Gloomy : Gay
# H
Happiness : Sorrow, sadness
Help : Hinder
Honour : Dishonour, shame
# I
Imperative : Optional
Increase : Decrease
Inhale : Exhale
# J
Joyful : Sad, depressed
Junior : Senior
Justice : InjusticeK
Kind : Cruel
Knowledge : Ignorance
# L
Lack : Plenty
Legal : Illegal
Legible : Illegible
# M
Mad : Sane
Malice : Goodwill
Master : Servant
# N
Natural : Artificial
Noble : Base, Ignoble
Normal : Abnormal
# O
Obstinate : Yielding
Offensive : Pleasing, defensive
Optional : Compulsory
# P
Part (n) : Yielding
Part (v) : Join
Particular : General
# Q
Quick : Slow, tardy
# R
Raise : Lower
Rash : Steady, cautious
Rear : Front
# S
Sacred : Unholy, profane
Satisfaction : Dissatisfaction
Scanty : Plentiful
# T
Tedious : Lively
Temperate : Intemperate
Thankful : Thankless
# U
Ugly : Beautiful
Union : Disunion, discord, split
Urban : Rural
# V
Vain : Modest
Violent : Gentle
Virtue : Vice
# W
Wane : Wax
Want : Abundance
War : Peace
# Y
Yield : Resist
Youth : Age
# Z
Zeal : Indifference
Zenith : Nadir
